
/##########
/#        #
/         #
/#        #
/#        #
/#        #
/#        #
/##########

@0,2~home@8,6
