
? #%_o><"RGBYx[X]

!0123456789012345
/xxxxxxxxxxxxxxxx
/x             ox
/x "  <xxxxxx  <x
/x    >  xR    >x
/x    <        <x
/xxxx >     xxxxx
/xG   <     xB  x
/x    >         x
/x    <         x
/x [XXX]        x
/x [YXXXX]>     x
/x    X   <     x
/x    x   >     x
/x        <     x
/x        >     x
/xxxxxxxxxxxxxxxx

