

!01234567
/_____~_)
/###>#W#]
/#&#<#H#]
/ ` . h ]
/     , ]
/.      ]

~0:6:map0
~3+3:map2
