

!01234567
/(_-____)
/[#W####]
/[#W#M##]
/[ w m $]
/[,     ]
/[    . ]

~6+1:map0

