?key: (_)"[#]RGBYOoX^CDEF

/RRRRRRRRRR
/B O  o   B
/B        B
/G  __    B
/G        B
/B        Y
/B    ^   Y
/######## #

@8,7~home@8,1
@2,1~exp@6,1
