? (_)"[#]RGBYOoX^CDEF

/##########
/#     _O #
/#        #
/#        #
/#        #
/#        #
/# B      #
/##########

@7,1~default@2,2

@2,6*exp1@7,4
