
/##########
/#        #
/         #
/#        #
/#        #
/#        #
/#         
/##########

@0,2~home@8,6
@9,6~Sage@1,0

