?key: (_)"[#]RGBYOoX^CDEF

/          
/G# #     R
/G  ###  #R
/G  ####  R
/G  ######R
/G    X   R
/G ^    ^BR
/YYYYYYYYYY

@0,0~map2@8,6
